███████████████
█         █   █
███ █████ █ █ █
█       █ █ █ █
█ ▓▓█ █ █ █ █ █
█  ▓  █ █ █ █ █
█ █ ███ █ █ ███
█ █     █ █   █
█ █ ▓ ███ █ █ █
█  ▓▓▓    █ █ █
█ █ ▓ ███████ █
█             █
█████████████ █
█             █
███████████████
