███████████████
█         █   █
█████████ █ █ █
█     █ █ █ █ █
█ ███ █ █ █ █ █
█ █ █ █ █ █ █ █
█ █ █ █ █ █ █ █
█ █   █ █ █ █ █
█ █ ███ █ █ █ █
█ █ █   █ █ █ █
█ █ ███ █ █ █ █
█ █     █ █ █ █
█ ███████ ███ █
█             █
███████████████
