███████████████
█             █
█████████████ █
█           █ █
█ █  ▓  █████ █
█ █ ▓▓▓       █
█  ▓▓▓█▓ ██████
█ █ ▓▓▓       █
█ █  ▓  ███████
█ █           █
█ █ █████████ █
█ █         █ █
█ ███████████ █
█             █
███████████████
