███████████████
█ █   █       █
█ █ █ █ █████ █
█ █ █ █ █   █ █
█ █ █ █ █ █ █ █
█ █ █ █ █ █ █ █
█ █ ███ █ █ █ █
█ █     █ █ █ █
█ █ ███████ █ █
█ █   █     █ █
█ ███ █ ███ █ █
█ █     █   █ █
█ ███████████ █
█             █
███████████████
